Użyte nazwy:

Desolation -> Dezolacja

engage
taunted
rend -> rozdarcie rozerwij

stamina - staminy


armour -> zbroja czy pancerz


achievement trait -> cecha osiągnięcia

Necro skin -> Trupia skóra
Devil's Pact -> Diabelski Pakt
Angel's Pact -> Anielski Pakt
Lethal Blow -> Śmiertelny cios
Furious -> Wściekłość
Mansplitter -> Rozłupywacz
Resilience -> Wytrwałość
Damage Recovery -> 
Speeder -> Śmigacz

Flesh -> Ciało (Mięso?)

Perk -> Profit
Trait -> Cecha

Stronghold -> Warownia
Fortress -> Forteca
Axeman -> Topornik (Rębacz?)
Bloodknight -> Krawy Rycerz

Engager -> ???

Boss -> Boss ?

Beast -> Bestia
Werebeast -> Bestiołak
Werebeast virus -> wirus tyriotropii (thirio = beast)
Cultist -> Kultysta
Revenant -> Zjawa, Upiór?
Valdor -> Valdorianie, Valdorczycy, Valdoriański Valdorski
Forsaken -> Zapomniani
Swamp -> z Mokradeł
Swampers -> Bagiennicy? Moczarowcy? Mokradłowcy?
Scavenger

